30 seconds=30 segundos
1 minute=1 minuto
2 minutes=2 minutos
5 minutes=5 minutos
10 minutes=10 minutos
30 minutes=30 minutos
1 hour=1 hora
2 hours=2 horas
Above=Por encima de
Array must be Started to view disk stats=El Array debe estar **iniciado** para ver las estadísticas del disco
Array must be Started to view system stats=El Array debe estar **iniciado** para ver las estadísticas del sistema
Available for Data=Disponible para datos
Below=Abajo
CPU Load=Carga de la CPU
Disk Usage=Uso del disco
disks=discos
High on Usage=Alto nivel de uso
Last day=Último día
Last 2 days=Últimos 2 días
Last 3 days=Últimos 3 días
Last week=La semana pasada
Last 2 weeks=Últimas 2 semanas
Last 3 weeks=Últimas 3 semanas
Last month=El mes pasado
Low on Space=Poco espacio
Normal Usage=Uso normal
Real-time=En tiempo real
Since start=Desde el inicio
Storage=Almacenamiento
Total Array Size=Tamaño total del Array
Total Space Used=Espacio total utilizado
Used for Parity=Se utiliza para la paridad
utilization in percentage=Porcentaje de uso
