%s ago=hace %s
%s used of %s %s %%=%s usados de %s (%s %%)
1 m=1 min
10 s=10 seg
2 m=2 min
30 s=30 seg
Active tunnels=Túneles activos
Activity=Actividad
ago=hace
Airflow=Refrigeración
All Apps=Todas las Apps
All VMs=Todas las VMs
Battery charge=Carga de la batería
BIOS dated=Fecha de la BIOS
Click to toggle CPU chart=Haga clic para mostrar/ocultar gráficos de la CPU
Click to toggle details=Haga clic para mostrar/ocultar los detalles
Completed=Completado
Counters info=Info de paquetes
Current operation %s on %s=Operación actual %s sobre %s
custom image=imagen personalizada
Data is invalid=Datos inválidos
default image=imagen predeterminada
Docker Containers=Contenedores Docker
Due in=Vence en
Elapsed time=Tiempo transcurrido
Errors info=Info de errores
Estimated finish=Tiempo estimado para terminar
failed device=el dispositivo ha fallado
Fan count=Número de ventiladores
FAN=Ventilador
Finding %s error=Resultado: **%s** error
Finding %s errors=Resultado: **%s** errores
General info=Info general
Go to CPU pinning settings=Ir al menú de asignación de CPU
Go to disk settings=Ir a los ajustes de disco
Go to Docker settings=Ir a los ajustes de Docker
Go to fan settings=Ir a los ajustes de refrigeración
Go to identification settings=Ir a los ajustes de identificación
Go to network settings=Ir a los ajustes de red
Go to scheduler settings=Ir a los ajustes de tareas programadas
Go to Share settings=Ir a los ajustes de recursos compartidos
Go to UPS settings=Ir a los ajustes del SAI
Go to User settings=Ir a los ajustes de usuarios
Go to VM settings=Ir a los ajustes de VM
Go to VPN settings=Ir a los ajustes de VPN
Handshake=Negociación
has=tiene
healthy=buen estado
heat warning=advertencia de temperatura
Hide details=Ocultar detalles
in progress=en curso
Inactive tunnels=Túneles inactivos
inactive=inactivo
Inbound=Recepción
invalid device=dispositivo inválido
invalid devices=dispositivos inválidos
Last check completed on %s=Última comprobación completada el **%s**
Last check incomplete on %s=Última comprobación incompleta el **%s**
Last checked on %s=Última comprobación el **%s**
Maximum size=Memoria máxima
Mode of operation=Modo de operación
Network traffic=Tráfico de red
Next check scheduled on %s=Siguiente comprobación programada para el **%s**
No docker containers defined=No hay ningún contenedor Docker instalado
No running docker containers=No hay ningún contenedor Docker en ejecución
No running virtual machines=No hay ninguna máquina virtual en ejecución
No shares present=No hay ninguna carpeta compartida
No virtual machines defined=No hay ninguna máquina virtual definida
Nominal power=Potencia nominal
not received=no recibido
Only PNG images are allowed=Solo se permiten las imagenes PNG
Outbound=Saliente
Overall Load=Carga total
Parity disk not present=No hay disco de paridad
Parity disks not present=No hay discos de paridad
Parity has not been checked yet=La paridad aún no ha sido comprobada
Parity is degraded=La paridad está degradada
Power=Alimentación
Put system to sleep=Suspender el sistema
Reboot the system=Reiniciar el sistema
Receive counters=De recepción
Received packets=Paquetes recibidos
Runtime left=Tiempo de batería restante
Scheduled parity check is disabled=No hay comprobaciones de paridad programadas
Select Case Model=Seleccione un modelo de chasis
Select time frame=Seleccione el periodo de tiempo
Share count %s with %s cache only and %s encrypted=Número de carpetas: %s con %s solo en caché y %s cifrada(s)
Show details=Mostrar detalles
Show Information=Mostrar información
Shutdown the system=Apagar el sistema
SMART error=Error de SMART
SMART health-check failed=Fallo en la comprobación SMART
SMART=SMART
sn=n/s
Start the array=Iniciar el Array
Started only=Solo en ejecución
Stop the array=Detener el Array
Temp=Temp
This will put the system to sleep=Esto suspenderá el sistema
This will reboot the system=Esto reiniciará el sistema
This will shutdown the system=Esto apagará el sistema
This will start the array=Esto iniciará el Array
This will stop the array=Esto detendrá el Array
Transmit counters=Contadores de envío
Transmitted packets=Paquetes enviados
UPS Load=Uso del SAI
UPS status=Estado del SAI
Usable size=Memoria usable
User count %s with %s unprotected=Número de usuarios: %s con %s desprotegido(s)
utilization warning=advertencia de uso de almacenamiento
View Running Processes=Ver procesos en ejecución
Virtual Machines=Máquinas Virtuales
5 m=5 minutos
Abort background operation=Cancelar operación en segundo plano
Abort background process=Cancelar proceso en segundo plano
Alert Message=Mensaje de alerta
Alerts=Alertas
Array Information=Información del Array
Attention - operation continues in background=Atención, la operación sigue en segundo plano
Close Tile=Cerrar
Content Management=Gestión de contenido
Fan Information=Información de ventilación
Information=Información
Interface Information=Información de interfaces
Lock sortable items=Bloquear elementos ordenables
Memory Utilization=Uso de memoria
Motherboard Information=Información de la placa base
Notices=Noticias
Notifications=Notificaciones
Output voltage=Voltaje de salida
Parity Information=Información de paridad
Pool=Pool
Power Status=Estado de energía
Processor Information=Información del procesador
Shares Information=Información de los share
ShowHide All Content=Mostrar/Ocultar todo el contenido
ShowHide Content=Mostrar/Ocultar contenido
This may leave an unknown state=Esto puede dejar un estado desconocido
Tile Management=Gestión de mosaicos
Unassigned Devices=Dispositivos no asignados
Unlock sortable items=Desbloquear elementos ordenables
UPS Model=MOdelo UPS
Users Information=Información de usuarios
VPN Connections=Conexiones VPN
Warnings=Advertencias
ZFS=ZFS
