Access Mode=Modo de Acceso
Add another Path, Port, Variable, Label or Device=Agregar otra Ruta, Puerto, Variable, Etiqueta o Dispositivo
Add Configuration=Agregar configuración
Add=Agregar
Additional Requirements=Requerimientos adicionales
Always=Siempre
App to Host=Usados por la App
Application=Aplicación
apply update=iniciar actualización
Array must be Started to view Docker containers=El array debe estar **Iniciado** para ver los contenedores Docker
Are you sure=Está seguro
Autostart=Auto-Iniciar
Back=Atrás
Backup=Copia de Seguridad
Beta=Beta
Books=Libros
By=De
Categories=Categorías
Check for Updates=Buscar Actualizaciones
Cloud=Nube
Config Type=Tipo de Configuración
Configuration not found=No se encontró la configuración
Connection Type=Tipo de Conexión
Console shell command=Tipo de Consola
Container ID=ID del Contenedor
Container Path=Ruta del Contenedor
Container Port=Puerto del Contenedor
Container Size=Tamaño de los Contenedores
Container=Contenedor
CPU Memory load=Uso de CPU & Memoria
CPU Pinning=Asignación de CPU
Created=Creado
Crypto Currency=
Default Value=Valor por Defecto
Device=Dispositivo
Display=Mostrar
DNS=DNS
Docker Containers=Contenedor Docker
Docker Hub URL=URL de DockerHub
Docker Service failed to start=No se pudo iniciar el servicio Docker
Downloaders=Gestores de Descarga
Drivers=Drivers
Edit Configuration=Editar Configuración
Exited=Terminado
Extra Parameters=Parámetros Adicionales
Fixed IP address=Dirección IP fija
force update=forzar actualización
FTP=FTP
Game Servers=Servidores de Juego
healthy=buen estado
Hide Buttons=Ocultar Botones
Hide docker allocations=Ocultar asignaciones Docker
Hide more settings=Ocultar opciones adicionales
Home Automation=Automatización del Hogar
Host Path=Ruta del Host
Host Port=Puerto del Host
HT=HT
Icon URL=URL del Icono
Image ID=ID de la Imagen
Key=Licencia
Label=Etiqueta
Management=Administración
MediaApp=AppMultimedia
MediaServer=ServidorMultimedia
Messenger=Mensajería
Missing parameters=Faltan parámetros
Music=Música
Network Type=Tipo de Red
No Docker containers installed=No hay ningún contenedor Docker instalado
None Listed=Ningún listado
of=de
orphan image=imagen huérfana
Other=Otros
Overview=Descripción
Path=Ruta
Pause All=Pausar Todos
Photos=Fotos
Port Mappings=Asignación de Puertos
Port=Puerto
Post Arguments=Argumentos Adicionales
Privileged=Acceso Privilegiado
Productivity=Productividad
Project Page=Página del Proyecto
Proxy=Proxy
Pulling image=Obteniendo imagen
Read Me First=Leer primero
Read Only - Shared=Solo Lectura - Compartido
Read Only - Slave=Solo Lectura - Esclavo
Read Only=Solo Lectura
ReadWrite - Shared=Lectura/Escritura - Compartido
ReadWrite - Slave=Lectura/Escritura - Esclavo
rebuild ready=reconstrucción lista
rebuilding=Reconstruyendo
Remove template=Eliminar plantilla
Removing container=Eliminando contenedor
Removing orphan image=Eliminando imagen huérfana
Repository=Repositorio
Required=Requerido
Reset sorting=
Resume All=Reanudar todos
Save=Guardar
Select a template=Seleccione una plantilla
Select categories=Seleccione categorías
Show docker allocations=Mostrar asignaciones Docker
Show more settings=Mostrar más opciones
Stable=Estable
Start All=Iniciar todos
starting up containers=Iniciando contenedores
Stop All=Detener todos
Stopping container=Deteniendo contendor
Successfully removed container=Contenedor eliminado con éxito
Successfully removed orphan image=Imagen huérfana eliminada con éxito
Successfully stopped container=Contenedor detenido con éxito
Support Thread=Sitio de Soporte
Template URL=URL de la plantilla
Template=Plantilla
The command failed=El comando ha fallado
The command finished successfully=El comando se completó con éxito
TOTAL DATA PULLED=DATOS TOTALES DESCARGADOS
Total size=Tamaño total
Unknown action=Acción desconocida
Update All=Actualizar todos
update ready=actualización lista
Value=Valor
Variable=Variable
Video=Video
Voip=Voip
Volume Mappings=Asignación de Volumenes
wait=espera
Was this container created using this plugin=Se creó este contenedor usando este plugin
Web=Web
WebUI=Interfaz Web
Writable=Grabable

; Note: June 6, 2022 - 2 missing translations
