Add Share=Crear Carpeta Compartida
All files encrypted=Todos los archivos están cifrados
All files protected=Todos los archivos están protegidos
All files unprotected=Todos los archivos están desprotegidos
Allocation method=Estrategia de almacenamiento
Array must be Started to view Shares=El Array debe estar **Iniciado** para ver los Recursos Compartidos
Automatically split any directory as required=Dividir automáticamente cualquier directorio según sea necesario
Automatically split only the top five directory levels as required=Dividir automáticamente solo los 5 primeros niveles del directorio según sea necesario
Automatically split only the top four directory levels as required=Dividir automáticamente solo los 4 primeros niveles del directorio según sea necesario
Automatically split only the top level directory as required=Dividir automáticamente solo el primer nivel del directorio según sea necesario
Automatically split only the top three directory levels as required=Dividir automáticamente solo los 3 primeros niveles del directorio según sea necesario
Automatically split only the top two directory levels as required=Dividir automáticamente solo los 2 primeros niveles del directorio según sea necesario
Comments=Comentarios
Compute All=Calcular Todos
Compute=Calcular
Disk Shares=Discos Compartidos
Do not use pool names=No use nombres de grupos de almacenamiento
Do not use reserved names=No use nombres reservados
Enable Copy-on-write=Habilitar Copy-on-Write
Enter a name for the share=Introduzca un nombre para la carpeta compartida
Excluded disks=Discos excluidos
Export=Compartir
Fill-up=Llenar
Free=Disponible
has been deleted=eliminada
HDD=HDD
High-water=Equilibrar
Included disks=Discos incluidos
Invalid Characters=Caracteres inválidos
Invalid share name=Nombre de carpeta compartida inválido
Manual do not automatically split directories=No dividir automáticamente los directorios
Minimum free space=Espacio mínimo disponible en disco
Missing share name=Falta el nombre de la carpeta compartida
Most-free=Más libre
Mover takes no action=El servicio Mover no actuará
Mover transfers files from array to cache=El servicio Mover moverá los archivos del Array al caché
Mover transfers files from cache to array=El servicio Mover moverá los archivos del caché al Array
next user share=siguiente carpeta compartida
Only=Solo
Prefer=Preferir
previous user share=carpeta compartida anterior
Primary storage for new files and folders=Primary storage (for new files and folders)
Read=Importar
Recompute=Recalcular
Rule=Regla
Select cache pool=Seleccione el grupo de almacenamiento caché
Set when adding new share only=Solo se puede definir al crear una nueva carpeta compartida
Share contains data=La carpeta compartida contiene datos
Share is empty=La carpeta compartida está vacía
Share is outside the list of designated disks=La carpeta compartida no está en la lista de discos designados
Share Settings=Ajustes de la Carpeta Compartida
Share status=Estado
Size=Tamaño
Some or all files unencrypted=Algunos o todos los archivos están sin cifrar
Some or all files unprotected=Algunos o todos los archivos están desprotegidos
Split level=Nivel de división
SSD=SSD
There are no exportable disk shares=No hay discos disponibles para compartir
There are no exportable user shares=No hay carpetas disponibles para compartir
Time Machine volume size limit=Tamaño límite del volumen de Time Machine
Unknown encryption state=Estado de cifrado desconocido
Use cache pool for new filesdirectories=Utilizar el almacenamiento caché (para nuevos archivos/directorios)
User Shares=Carpetas Compartidas
Write=Exportar
You cannot use the following within share names=No use los siguientes caracteres en el nombre de la carpeta compartida

; Note: April 28, 2023 - 16 missing translations
Calculated free space value=
Clean Up=
CLEAN UP=
Exclusive access=
Mover action=
Mover transfers files from Primary storage to Secondary storage=
Mover transfers files from Secondary storage to Primary storage=
No unused share configurations present=
Not used=
Primary storage %s=
Primary storage to Secondary storage=
Remove unused share configurations=
Removed share configurations=
Secondary storage to Primary storage=
Secondary storage=
Storage=
