Automatic theming=Tematización automática
Bing API key=Clave de la API de Bing
Bing=Bing
City name=Nombre de la ciudad
Country name=Nombre del país
Day theme=Tema diurno
Geocoding service=Servicio de geocodificación
Google API key=Clave de la API de Google
Google=Google
MapQuest API key=Clave de la API de MapQuest
MapQuest=MapQuest
Night theme=Tema nocturno
No geographical coordinates found for the given address=No se han encontrado coordenadas geográficas para la dirección indicada
Please adjust=Por favor, ajuste
Postal code=Código postal
See=Ver
Street address=Dirección de la calle
this site=este sitio
to obtain a Bing API key=para obtener una clave de la API de Bing
to obtain a Google API key=para obtener una clave de la API de Google
to obtain a MapQuest API key=para obtener una clave de la API de MapQuest

:day_night_plug:
> Introduzca la información de su dirección (calle, ciudad, país) que se utiliza para calcular las horas de salida y puesta del sol de su ubicación.
>
> Se utiliza un servicio de geocodificación para convertir su dirección en coordenadas geográficas (latitud y longitud).<br>
> Tienes que registrarte en uno de los servicios disponibles y obtener una clave de API única para hacer uso de su servicio.
>
> El tema del **day** se selecciona entre el amanecer y el atardecer<br>
> El tema **night** se selecciona entre la puesta y la salida del sol
:end
